"filename", "language", "JSON with Comments", "Properties", "C++", "Markdown", "comment", "blank", "total"
"c:\Users\phil\Documents\Arduino\libraries\asyncmqtt\README.md", "Markdown", 0, 0, 0, 7, 0, 6, 13
"c:\Users\phil\Documents\Arduino\libraries\asyncmqtt\aworkingversion.code-workspace", "JSON with Comments", 7, 0, 0, 0, 0, 0, 7
"c:\Users\phil\Documents\Arduino\libraries\asyncmqtt\examples\AsyncMQTT_tester\AsyncMQTT_tester.ino", "C++", 0, 0, 105, 0, 0, 26, 131
"c:\Users\phil\Documents\Arduino\libraries\asyncmqtt\library.properties", "Properties", 0, 9, 0, 0, 0, 1, 10
"c:\Users\phil\Documents\Arduino\libraries\asyncmqtt\src\AsyncMQTT.cpp", "C++", 0, 0, 210, 0, 3, 21, 234
"c:\Users\phil\Documents\Arduino\libraries\asyncmqtt\src\AsyncMQTT.h", "C++", 0, 0, 123, 0, 7, 19, 149
"c:\Users\phil\Documents\Arduino\libraries\asyncmqtt\src\Packet.cpp", "C++", 0, 0, 184, 0, 4, 16, 204
"c:\Users\phil\Documents\Arduino\libraries\asyncmqtt\src\Packet.h", "C++", 0, 0, 133, 0, 0, 10, 143
"c:\Users\phil\Documents\Arduino\libraries\asyncmqtt\src\config.h", "C++", 0, 0, 3, 0, 2, 3, 8
"Total", "-", 7, 9, 758, 7, 16, 102, 899